



  111  111
 1222112221
 1233223321
 1234444321
  12344321
   123321
    1221
     11